X X X X X X X X X X
X P X X X X X X X X
X       E       E X
X X X X   X X X   X
X X X X   X X X   X
X S     E       E X
X X X X   X X X   X
X X X X   X X X   X
X G     E       E X
X X X X X X X X X X
